444444444444444444444444444444444444444444444444444444444444444444444444444444444444444
411111111111111111111111111111111111111111111111111111111111111111111111111111111111114
411111111111111111111111111111111111111111111111111111111111111111111111111111111111114
411111222211133331114444111111111111111111111111111111111111111111111111111111111111114
411111222211133331114444111111111111111111111111111111111111111111111111111111111111114
411111222211133331114444111111111111111111111111111111111111111111111111111111111111114
411111222211133331114444111111111111111111111111111111111111111111111111111111111111114
411111111111111111111111111111111111111111111111111111111111111111111111111111111111114
411111111111111111111111111111111111111111111111111111111111111111111111111111111111114
411111111111111111111111111111111111111111111111111111111111111111111111111111111111114
411111111111111111111111111111111111111111111111111111111111111111111111111111111111114
411111111111111111111111111111111111111111111111111111111111111111111111111111111111114
411111111111111111111111111111111111111111111111111111111111111111111111111111111111114
411111111111111111111111111111111111111111111111111111111111111111111111111111111111114
411111111111111111111111111111111111111111111111111111111111111111111111111111111111114
411111111111111111111111111111111111111111111111111111111111111111111111111111111111114
411111111111111111111111111111111111111111111111111111111111111111111111111111111111114
411111111111111111111111111111111111111111111111111111111111111111111111111111111111114
411111111111111111111111111111111111111111111111111111111111111111111111111111111111114
411111111111111111111111111111111111111111111111111111111111111111111111111111111111114
411111111111111111111111111111111111111111111111111111111111111111111111111111111111114
411111111111111111111111111111111111111111111111111111111111111111111111111111111111114
411111111111111111111111111111111111111111111111111111111111111111111111111111111111114
411111111111111111111111111111111111111111111111111111111111111111111111111111111111114
411111111111111111111111111111111111111111111111111111111111111111111111111111111111114
441111111111111111111111111111111111111111111111111111111111111111111111111111111111114
441111111111111111111111111111111111111111111111111111111111111111111111111111111111114
411111111111111111111111111111111111111111111111111111111111111111111111111111111111114
411111111111111111111111111111111111111111111111111111111111111111111111111111111111114
411111111111111111111111111111111111111111111111111111111111111111111111111111111111114
411111111111111111111111111111111111111111111111111111111111111111111111111111111111114
411111111111111111111111111111111111111111111111111111111111111111111111111111111111114
411111111111111111111111111111111111111111111111111111111111111111111111111111111111114
411111111111111111111111111111111111111111111111111111111111111111111111111111111111114
411111111111111111111111111111111111111111111111111111111111111111111111111111111111114
411111111111111111111111111111111111111111111111111111111111111111111111111111111111114
411111111111111111111111111111111111111111111111111111111111111111111111111111111111114
411111111111111111111111111111111111111111111111111111111111111111111111111111111111114
411111111111111111111111111111111111111111111111111111111111111111111111111111111111114
411111111111111111111111111111111111111111111111111111111111111111111111111111111111114
444444444444444444444444444444444444444444444444444444444444444444444444444444444444444
