3333333333333333333333333333333333333333333333333333333333333333333333333333333333333333333333333333333333333333333333333333333333333333333333333333333333333333
1111111111111111111111111111111111131111111111111111111111111111111111111111111111111111111111111111111322222222222223111111111111111132222222222222222222222222
1111133311111111111111111111111111131111111111111111111111111111111111111111111111111111111111111111111132222222222222311111111111111132222222222222222222222222
1111133311111111111111111111111111131111111111111111111111111111111111111111111111111111111111111111111333333322222223111111111111111132222222222222222222222222
3111133311111111111111111111111111131111111111111111111111111111111111111111111111111111111111111111111111113222222231111111111111111132222222222222222222222222
3111136111111111111111111661111111131111111116661111111111111111111111111111111111111111111111111111111111111132222222311111111111111132222222222222222222222222
3111111111111111111111116666666111131111111111111111111111111111666611111111111111111166661111111111111111111132222222311111111111111132222222222222222222222222
3111111111111111111111116111116111131111111111111111111111111111111111111111111111111111111111111111111113111113222222231111111111111113222222222222222222222222
3111111111111111111111116166616111131111111111111111111111111111111111111111111111111111111111111111111131111133333333311111111111111132222222222222222222222222
3111111111111111111111116166616111131111113111111111111111111111111111111111111111111111111111111111111131111111111111111111111111111132222222222222222222222222
3111116666111111111111116166616111131111111311111111111111111111111111111111111111111111111111111111111113111111111111111111111111111113222222222222222222222222
3111111111111111111111116111116111131111111311111111111111111111111111111111111111111111111111111111111113111111111111111111111111111113222222222222222222222222
3111111111111111111111116666666111131111111311111111111111111111111111111111111111111111111111111111111113111113333333331111111111111113222222222222222222222222
3111111111111111111111111111111111131111111311111111111111111111111111111111111111111111111111111111111113111113111111111111111111111113222222222222222222222222
3111111111111111111111111111111111131111111311111111111111111111111111111111111111111111111111111111111111111113111111111111111111111113222222222222222222222222
3111111111111111111111111111111111131111111311111111111111111111111111111111111111111111111111111111111111111113111111111111111111111113222222222222222222222222
3111111111111111111111111111111111131111111311111111111111111111111111111111111111111111111111111111111111111113111111111111111111111113222222222222222222222222
3111111111111111111111111111111111131111111311111111111111111111111111111111111111111111111111111111111113333333111111111111111111111113222222222222222222222222
3333333333333333333333333333333333333333333333333331111111111111111111111111111111111111111111111111111131111111111111111111111111111132222222222222222222222222
3111111111111111111111111111111111111111111111111111111111111111111111111111111111111111111111111111111131111111111111111111111111111132222222222222222222222222
3111111111111111111111111111111111111111111111111111111111111111111111111111111111111111111111111111111131111111111111111111111111111132222222222222222222222222
3111111111111111111111111111111111111111111111111111111111111111111111111111111111111111111111111111111133333333333333333333333333333332222222222222222222222222
3111111111111111111111111111111111111111111111111111111111111111111111111111111111111111111111111111111132222222222222222222222222222222222222222222222222222222
3111111111111111111111111111111111111111111111111111111111111111111111111111111111111111111111111111111132222222222222222222222222222222222222222222222222222222
3111111111111111111111111111111111111111111111111111111111111111111111111111111111111111111111111111111132222222222222222222222222222222222222222222222222222222
3111111111111111111111111111111111111111111111111111111111111111111111111111111111111111111111111111111133333333333333333333333333333332222222222222222222222222
3111111111111111111111111111111111111111111111111111111111111111111111111111111111111111111111111111111133333333333333333333333333333332222222222222222222222222
3111111111133333333331111111111111111111111111111111111111111111111111111111111111111111111111111111111133333333333333333333333333333332222222222222222222222222
3111111111133311113331111111111111111111111111111111111111111111111111111111111111111111111111111111111133333333333333333333333333333332222222222222222222222222
3111111111133311113331111111111111111111111111111111111111111111111111111111111111111111111111111111111133333333333333333333333333333332222222222222222222222222
3111111111111111113331111111111111111111111111111111111111111111111111111111111111111111111111111111111133333333333333333333333333333332222222222222222222222222
3111111111111111113331111111111111111111111111111111111111111111111111111111111111111111111111111111111133333333333333333333333333333332222222222222222222222222
3111111111111113333331111111111111111111111111111111111111111111111111111111111111111111111111111111111133333333333333333333333333333332222222222222222222222222
3111111111111111111111111111111111111111111111111111111111111111111111111111111111111111111111111111111133333333333333333333333333333332222222222222222222222222
3111111111111111111111111111111111111111111111111111111111111111111111111111111111111111111111111111111133333333333333333333333333333332222222222222222222222222
3111111111111111111111111111111111111111111111111111111111111111111111111111111111111111111111111111111133333333333333333333333333333332222222222222222222222222
3111111111111111111111111111111111111111111111111111111111111111111111111111111111111111111111111111111133333333333333333333333333333332222222222222222222222222
3111111111111111111111111111111111111111111111111111111111111111111111111111111111111111111111111111111133333333333333333333333333333332222222222222222222222222
3111111111111111111111111111111111111111111111111111111111111111111111111111111111111111111111111111111133333333333333333333333333333322222222222222222222222222
3111111111111111111111111111111111111111111111111111111111111111111111111111111111111111111111111111111133333333333333333333333333333332222222222222222222222222
3111111111111111111111111111111111111111111111111111111111111111111111111111111111111111111111111111111133333333333333333333333333333332222222222222222222222222
3111111111111111111111111111111111111111111111111111111111111111111111111111111111111111111111111111111133333333333333333333333333333332222222222222222222222222
3111111111111111111111111111111111111111111111111111111111111111111111111111111111111111111111111111111133333333333333333333333333333332222222222222222222222222
3111111111111111111111111111111111111111111111111111111111111111111111111111111111111111111111111111111133333333333333333333333333333332222222222222222222222222
3111111111111111111111111111111111111111111111111111111111111111111111111111111111111111111111111111111133333333333333333333333333333332222222222222222222222222
3111111111111111111111111111111111111111111111111111111111111111111111111111111111111111111111111111111133333333333333333333333333333332222222222222222222222222
3111111111111111111111111111111111111111111111111111111111111111111111111111111111111111111111111111111133333333333333333333333333333332222222222222222222222222
3111111111111111111111111111111111111111111111111111111111111111111111111111111111111111111111111111111133333333333333333333333333333332222222222222222222222222
3111111111111111111111111111111111111111111111111111111111111111111111111111111111111111111111111111111133333333333333333333333333333332222222222222222222222222
3333333333333333333333333333333333333333333333333333333333333333333333333333333333333333333333333333333333333333333333333333333333333332222222222222222222222222

