333333333333333333333333333333333333333333333333333333333333333333333333333333333333333333333333333333333333333333333333
333333333333333333000000000000000000000000000000000000000000000000000000000000000000000000000001222221000000000000000003
333331133333333000000000000000000000000000000000000000000000000000000000000000000000000000000001222223000000000000000003
333333333300000000000000000000000000000000000000000000000000000000000000000000000000000000000003222221100000000000000003
333113333330000000000000000000000000000000000000000000000000000000000000000000000000000000000000322222100000000000000003
333313330000000000000000000000000000000000000000000000000000000033333333330000000000000000000000122222333330000000000003
333333300000000000000000000000000000000333333333333300000000000003333333333333333330000000000000132222231130000000000003
333333300000000000000000000000000333333333333333333333300000000000333333333333000000000000000000132222231130000000000003
333330000000000000000000000033333333000000000000000000000000000000333333330000000000000000000001132222231130000000000003
333000000000000000000000000000000000000000000000000000000000000000033333000000000000000000000001133333333330000000000003
330000000000000000000000000000000000000333333333000000000000000000003333330000000000000000000000000000000000000000000003
330000000000000000000000000000333333333333322233333330000000000000000333333333000000000000000000000000000000000000000003
330000000000000000000000000000000333333222222222133333330000000000000333333000000000000000000001133333331130000000000003
330000000000000000000000000000000000022222222222211333300000000000000003333330000000000000000001132222221330000000000003
330000000000000000000000000000000000222222222222221333333300000000000333333000000000000000000001132222231130000000000003
333000000000000000000000000000000022222222222222213333330000000000033333000000000000000000000003132222231133000000000003
330000000000000000000000000000000022222222222222233333300000000000000000000000000000000000000001132222231113300000000003
330000000000000000000000000000000022222222222223333330000000000000000000000000000000000000000000132222231111333000000003
333000000000000000000000000000000022222222222333333000000000000000000000000000000000000000000000032222231111133300000003
333300000000000000000000000000000222222222223333333000000000000003333333000000000000000000000000032222231111330000000003
333330000000000000000000000000000002222222222233333333300000003333333000000000000000000000000000032222231113300000000003
333333000000000000000000000000000000002222222222233333330000333333000000000000000000000000000000003222223133000000000003
300333333000000000000000000000000000000000022222222333333333333333000000000000000000000000000000003222223130000000000003
300000333333000000000000000000000000000000000002222222233333000000000000000000000000000000000000003222223130000000000003
300000003333333000000000000000000000000000000000000000000000000000000000000000000000000000000000000322222330000000000003
300000000033330000000000000000000000000000000000000000000000000000000000000000000000000000000000000322222330000000000003
300000000003333300000000000000000000000000000000000000000000000000000000000000000000000000000000000032222233000000000003
300000000333330000000000000000000000000000000000000000000000000000000000000000000000000000000000000000222223300000000030
300000000033333333000000000000000000000303333333333333330000000000000000000000000000000000000000000000222222330000000003
300000000000033333333000000000000000000303000000000000030000000000000000000000000000000000000000000000022222233000000003
300000000000003333300000000000000000000303033333333303030000000000000000000000000000000000000000000000012222223110000030
300000000000000033333333300000000000000303000030000303030000000000000000000000000000000000000000000000001222222211300030
300000000000000000000000000000000000000303000030000303030000000000000000000000000000000000000000000000000122222222333103
300033333330000000000000000000000000000303000030000303030000000000000000000000000000000000000000000000000012222222222202
300000333333300000000000000000000000000303000000000003030000000000000000000000000000000000000000000000000000022222222200
300000003333330000000000000000000000000303333333333333030000000000000000000000000000000000000000000000000000000222222220
300000333330000000000000000000000000000300000000000000030000000000000000000000000000000000000000000000000000000022222202
300000003333333000033330000000000000000333333333333333330000000000000000000000000000000000000000031111100000000000000030
300000000333330000003333300000000000000000000000000000000000000000000000000003111113330000000000000000000000000000000003
300000033333300000000033333000000000000000000000000000000000000000000000000311111330000000000000000000000000000000000003
300000333333000000003333300000000000000000000000000000000000000000000000031111133000000000333300000000000000000000000003
300003333333333300000033333300000000000000000000000000000000000000000003111133000000000033111330000000331100000000000003
300000003333330000000003333333330000000000000000000000000000000000000031113300000000003111300000000003111110000000000003
300000000033300000000000003333333300000000000000000000000000000000000311133000000003311300000000000003311100000000000003
300000000000000000000000000000000000000000000000000000000000000000003111330000000311333000000000000000331111100000000003
300000000000000000000000000000000000000000000000000000000000000000311133300000003113000000000000000000003333110000000003
300000000000000000000000000000000000000000000000000000000000000033111133000003311330000000000000000000000000000000000003
300000000000000000000000000000000000000000000000000000000000000003111113300000031130000000000000000000000000000000000033
300000000000000000000000000000000000000000000000000000000000000003111113330000003330000000000000000000000033333000003333
300000000000000000000000000000000000000000000000000000000000000003111113300000000011300000000000000000000331113333333333
300000000000000000000000000000000000000000000000000000000000000003311113000000000113330000000000000000000333313113331133
333333300000000000000000000000000033333333333330000000000000000033331111300000000001130000000000000000033113331111331133
333333333003000000000000000333333333333333000000000000000000000333333111133000000000031111000000000033111130333111133333
333333333330333300000000003333333000000000000000000000000000033333333311111133000000000311113000000311110000033311111133
333333333333333330000000033333000000000000000000000000000033333333333333111111300000000003330000000000000000000331133333
333333333330000000000000330000000000000000000000000000000333333333333333311111111300000000000000000000000000033333111333
333333330000000000000003330000000000033300000333333300033333333333333333331111111113300000000000000000000000000033313333
333333300000000000000033033000000000333333333333333333333333333333333333333311111111113333000000000000000000000003333333
333333333333333333333333333333333333333333333333333333333333333333333333333333333333333333333333333333333333333333333333



