11111111111111111111111111111111111111111111111111111
13333333333333333333333222223333333333333333333331
13000000003300000000033222223300000000000003300031
13000000003300000000033222223300000000000003300031
13000000003300000000033222223300000000000003300031
13000033333333330000033222223300000330000003300031
13000031113311130000033222223300003333000003300031
13000031113311130000033222223300033333300000000031
13000031113311130000033222223333333333300000000031
13000033333333330000033222223300033333300000000031
13000033333333330000033222223300003333000003300031
13000031113311130000033222223300000330000003300031
13000031113311130000033222223300000000000003300031
13000031113311130000033222223300000000000003300031
13000033333333330000033222223300000000000003300031
13000000000000000000033222223300000330000003300031
13000000000000000000033222223300003333000003300031
13000000000000000000033333333300033333300003300031
13000000000000000000000000000000033333333333300031
13000000000000000000000000000000033333300003300031
13000000000000000000000000000000003333000003300031
13333333333333000333333333333300000330000003300031
13000300031113000300033222223300000000000003300031
13000300000003000300033222223300000000000003300031
13000300000003000300033222223300000000000003300031
13000300000003000300033222223300000330000003300031
13000300030003000300033222223300003333000003300031
13000300030003000300033222223300033333300003300031
13000300030003000300033222223333333333333333300031
13000300030003000300033222223300033333300003300031
13000300030003000300033222223300003333000003300031
13000300030000000300033222223300000330000003300031
13000300030000000300033222223300000000000000000031
13000300030000000300033222223300000000000000000031
13000000030003000300033222223300000000000000000031
13000000030003000000033222223300000330000003300031
13000000030003000000033222223300003333000003300031
13111300030003111111133222223300033333300003300031
13333333333333333333333222223333333333333333333331
11111111111111111111111111111111111111111111111111
1
1
1
1

