((((((((((((((((((((((((((((((((((((((((((((((((((((((((((((((((((((((((((((((((1111111111111111111111111111111111111111
)111111111111111111111111111111111111111111111111111111111111~~1111111111111111-3111111111111111111111111111111111111111
)111111111111111111111111111111111111111111111111111111111111~~111>111>111>1111-3111111111111111111111111111111111111111
)11111111111>1111#########11111111111111111111111111111111111~~1111111111111111--111111111111111111111111111111111111111
)1111111111111111@@@@@@@@@11111111111111111111111111111111111~~1111111111111111--111111111111111111111111111111111111111
)1111111111111111:::::::::11111111111111111111111111111111111~~1111111111111111--111111111111111111111111111111111111111
)11111111111/111111111111111111111111111111111111111111111111~~111/111/111/1111--111111111111111111111111111111111111111
)111111111111111111111111111111111111111111111111111111111111~~1111111111111111--111111111111111111111111111111111111111
)111111111111111111111111111111111111111111111111111111111111~~1111111111111111-1111111111111111111111111111111111111111
)111111111111111111111111111111111111111111111111111111111111[{DDDDDDDDDDDDDDDDD1111111111111111111111111111111111111111
)111111111111111111111111111111111111111111111111111111111111[{EEEEEEEEEEEEEEEEEE111111111111111111111111111111111111111
)111111111111111111111111111111111111111111111111111111111111[{_________________1111111111111111111111111111111111111111
)111111111111111111111111111111111111111111111111111111111111~~1111111111111111-1111111111111111111111111111111111111111
)111111111111111111111111111111111111111111111111111111111111~~1111111111111111-1111111111111111111111111111111111111111
)111111111111111111111111111111111111111111111111111111111111~~1111111111111111-1111111111111111111111111111111111111111
)111111111111111111111111111111111111111111111111111111111111~~111-111111111111-1111111111111111111111111111111111111111
)111111111111111111111111111111111111111111111111111111111111~~111-111111111111-1111111111111111111111111111111111111111
)111111111111111111111111111111111111111111111111111111111111~~111-111111111111-1111111111111111111111111111111111111111
)111111111111111111111111111111111111111111111111111111111111~~111-111111111111-1111111111111111111111111111111111111111
)111111111111111111111111111111111111111111111111111111111111~~111-111111111111-3111111111111111111111111111111111111111
)111111111111111111111111111111111111111111111111111111111111..111-111111111111-3111111111111111111111111111111111111111
)111111111111111111111111111111111111111111111111111111111111<<111-111111111111-1111111111111111111111111111111111111111
)111111111111111111111111111111111111111111111111111111111111~~111-111111111111-1111111111111111111111111111111111111111
)111111111111111111111111111111111111111111111111111111111111~~111-111111111111-1111111111111111111111111111111111111111
)111111111111111111111111111111111111111111111111111111111111~~111-(((((((((((((1111111111111111111111111111111111111111
)111111111111111111111111111111111111111111111111111111111111~~1111111111111111-1111111111111111111111111111111111111111
)111111111111111111111111111111111111111111111111111111111111~~1111111111111111-1111111111111111111111111111111111111111
)111111111111111111111111111111111111111111111111111111111111~~1111111111111111-1111111111111111111111111111111111111111
)111111111111111111111111111111111111111111111111111111111111~~1111111111111111-3111111111111111111111111111111111111111
)111111111111111111111111111111111111111111111111111111111111~~1111111111111111-3111111111111111111111111111111111111111
)11111111111111111111111111111111111111111111111111111111111-~~-((((11((((((((((-311111111111111111111111111111111111111
)11111111111111111111111111111111111111111111111111111111111-~~-111111111111111-3111111111111111111111111111111111111111
)1111111111111111111111111111111111111111111111111z111111111-~~-111111111111111-1111111111111111111111111111111111111111
)111111111111111111111111111111111111111111111111111111111111~~-111111111111111-3111111111111111111111111111111111111111
)111111111111111111111111111111111111111111111111111111111111~~-11111111111111111111111111111111111111111111111111111111
)11111111111111111111111111111111111111111111111111111111111-~~-111111111111111-1111111111111111111111111111111111111111
)11111111111111111111111111111111111111111111111111111111111-~~-11111111111111#-1111111111111111111111111111111111111111
)11111111111111111111111111111111111111111111111111111111111-~~-1111111111111##-1111111111111111111111111111111111111111
)11111111111111111111111111111111111111111111111111111111111-~~111111OPQR:#1###-1111111111111111111111111111111111111111
)11111111111111111111111111111111111111111111111111111111111-~~111111STUV:#####-11111111111111111111111111111111111111
1
)11111111111111111111111111111111111111111111111111111111111-~~111111WXYZ:#####-111111111111111111111111111111111111
111
)11111111111111111111111111111111111111111111111111111111111-~~-11111!"£$:#####-1111111111111111111111111111111111
11111
)11111111111111111111111111111111111111111111111111111111111-~~-11111%^&*:#####-111111111111111111111111111111111111111

)11111111111111111111111111111111111111111111111111111111111-~~-11111:::::#####-11111111111111111111111111111111
1111111
)11111111111111111111111111111111111111111111111111111111111-~~-11111#@@#######-111111111111111111111111111111111
111111
)111111111111111111111111111111111111111111111111111111111111~~-11111#@@#######-111111111111111111111111111111111
111111
)111111111111111111111111111111111111111111111111111111111111~~-11111#@@#######-1111111111111111111111111111111111
11111
)11111111111111111111111111111111111111111111111111111111111-~~-1111##@@#######-3111111111111111111111111111111111111111
)11111111111111111111111111111111111111111111111111111111111-~~-111###@@#######-1111111111111111111111111111111111111111
((((((((((((((((((((((((((((((((((((((((((((((((((((((((((((((((((((((((((((((((1111111111111111111111111111111111111111
1111111111111111111111111111111111(((((111111111111111111111111111111111111111111111111111111111111111111111111111111111
111111111111111111111111111111111111111111111111111111111111111111111111111111111111111111111111111111111111111111111111
111111111111111111111111111111111111111111111111111111111111111111111111111111111111111111111111111111111111111111111111
111111111111111111111111111111111111111111111111111111111111111111111111111111111111111111111111111111111111111111111111
111111111111111111111111111111111111111111111111111111111111111111111111111111111111111111111111111111111111111111111111
111111111111111111111111111111111111111111111111111111111111111111111111111111111111111111111111111111111111111111111111
111111111111111111111111111111111111111111111111111111111111111111111111111111111111111111111111111111111111111111111111
111111111111111111111111111111111111111111111111111111111111111111111111111111111111111111111111111111111111111111111111
111111111111111111111111111111111111111111111111111111111111111111111111111111111111111111111111111111111111111111111111
111111111111111111111111111111111111111111111111111111111111111111111111111111111111111111111111111111111111111111111111
111111111111111111111111111111111111111111111111111111111111111111111111111111111111111111111111111111111111111111111111
111111111111111111111111111111111111111111111111111111111111111111111111111111111111111111111111111111111111111111111111
111111111111111111111111111111111111111111111111111111111111111111111111111111111111111111111111111111111111111111111111
111111111111111111111111111111111111111111111111111111111111111111111111111111111111111111111111111111111111111111111111
111111111111111111111111111111111111111111111111111111111111111111111111111111111111111111111111111111111111111111111111
111111111111111111111111111111111111111111111111111111111111111111111111111111111111111111111111111111111111111111111111
111111111111111111111111111111111111111111111111111111111111111111111111111111111111111111111111111111111111111111111111
111111111111111111111111111111111111111111111111111111111111111111111111111111111111111111111111111111111111111111111111
111111111111111111111111111111111111111111111111111111111111111111111111111111111111111111111111111111111111111111111111
111111111111111111111111111111111111111111111111111111111111111111111111111111111111111111111111111111111111111111111111
111111111111111111111111111111111111111111111111111111111111111111111111111111111111111111111111111111111111111111111111
111111111111111111111111111111111111111111111111111111111111111111111111111111111111111111111111111111111111111111111111
111111111111111111111111111111111111111111111111111111111111111111111111111111111111111111111111111111111111111111111111
111111111111111111111111111111111111111111111111111111111111111111111111111111111111111111111111111111111111111111111111
111111111111111111111111111111111111111111111111111111111111111111111111111111111111111111111111111111111111111111111111
