((((((((((((((((((((((((((((((((((((((((((((((((((((((((((((((((((((((((((((((((1111111111111111111111111111111111111111
)1111111111111~~111111111111111111111111111111111111111111111~~1111111111111111-3111111111111111111111111111111111111111
)1111111111111~~1111111111111111##111111111111111111111111111~~111>111>111>1111-3111111111111111111111111111111111111111
)1111111111111~~111111111111111111111111111#11111111111111111~~1111111111111111--111111111111111111111111111111111111111
)1111111111111~~111111111111111111111111111111111111111111111~~1111111111111111--111111111111111111111111111111111111111
)1111111111111~~1111@@@@@@@@@@1111111111111111111111111111111~~1111111111111111--111111111111111111111111111111111111111
)1111111111111~~1111###::::###1111111111111111111111111111111~~111/111/111/1111--111111111111111111111111111111111111111
)1111111111111~~1111###::::###111111111111111111##11111111111~~1111111111111111--111111111111111111111111111111111111111
)1111111111111~~1111@@@@@@@@@@1111111111111111111111111111111~~1111111111111111-1111111111111111111111111111111111111111
)1111111111111~~1111111111111111111IDDDDDDDDDDDDDDDDDDDDDDDDD[{DDDDDDDDDDDDDDDDD1111111111111111111111111111111111111111
)1111111111111~~111111111111111111IJEEEEEEEEEEEEEEEEEEEEEEEEE[{EEEEEEEEEEEEEEEEEE111111111111111111111111111111111111111
)1111111111111~~11111111111111111IJK_________________________[{_________________1111111111111111111111111111111111111111
)1111111111111~~1111111111111111IJK+1111111111111111111111111~~1111111111111111-1111111111111111111111111111111111111111
DDDDDDDDDDDDDD[{DDDDDDDDDDDDDDDDJK+11/11111111111111111111111~~1111111111111111-1111111111111111111111111111111111111111
EEEEEEEEEEEEEE[{EEEEEEEEEEEEEEEEK+111111111111111111111111111~~1111111111111111-1111111111111111111111111111111111111111
______________[{________________+((((((((((((((((111111111111~~111-111111111111-1111111111111111111111111111111111111111
)111111111111-~~)11111111111111111111111111111111111111111111~~111-111111111111-1111111111111111111111111111111111111111
)81111>111111-~~)1>11/111111111111111111111111111111111111111~~111-111111111111-1111111111111111111111111111111111111111
)11OPQR1,1111-~~)11111111111111111111111111111111111111111111~~111-111111111111-1111111111111111111111111111111111111111
)11STUV1,1111-~~((((((111111111111111111111111111111111111111~~111-111111111111-3111111111111111111111111111111111111111
)11WXYZ111111-.................................................111-111111111111-3111111111111111111111111111111111111111
)11!"£$111111-<<<<<<<<<<<<<<<<<<<<<<<<<<<<<<<<<<<<<<<<<<<<<<<<<111-111111111111-1111111111111111111111111111111111111111
)11%^&*111111-~~((((((111111111111111111111111111111111111111~~111-111111111111-1111111111111111111111111111111111111111
)111111111111-~~)11111111111111111111111111111111111111111111~~111-111##@@##111-1111111111111111111111111111111111111111
)OPQR11111111-~~)11111111111111111111111111111111111111111111~~111-(((((((((((((1111111111111111111111111111111111111111
)STUV11111111-~~)11111111111111111111111111111111111111111111~~1111111111111111-1111111111111111111111111111111111111111
)WXYZ11111111-~~)11111111111111111111111111111111111111111111~~1111111111111111-1111111111111111111111111111111111111111
)!"£$111111111~~111111111111111111111IDDDDDDDz11111111,111111~~1111111111111111-1111111111111111111111111111111111111111
)%^&*111111111~~1111111111,111111111IJEEEEEEExz11111111111111~~1111111111111111-3111111111111111111111111111111111111111
)1111111111111~~1111111111111111111IJKFFFFFFFyxz1111111111111~~1111111111111111-3111111111111111111111111111111111111111
)1111811111111~~111111111111111111IJKLGGGGGGGAyxz11111111111-~~-((((((((((((((((-3111111111111111111111111111111111111111
)1111111111111~~11111111111111111IJKLMHHHHHHHBAyxz1111111111-~~-######@@#######-3111111111111111111111111111111111111111
DDDDDDDDDDDDDDDDDDDDDDDDDDDDDDDDDJKLMN2222222CBAyxz111111111-~~-######@@#######-1111111111111111111111111111111111111111
EEEEEEEEEEEEEEEEEEEEEEEEEEEEEEEEEKLMN222222222CBAyx1111111111~~-######@@#######-3111111111111111111111111111111111111111
FFFFFFFFFFFFFFFFFFFFFFFFFFFFFFFFFLMN22222222222CBAu1111111111~~-######@@#######-1111111111111111111111111111111111111111
GGGGGGGGGGGGGGGGGGGGGGGGGGGGGGGGGMN2222222222222wvu111111111-~~-######@@#######-1111111111111111111111111111111111111111
HHHHHHHHHHHHHHHHHHHHHHHHHHHHHHHHHN22222222222222wvu111111111-~~-######@@#######-1111111111111111111111111111111111111111
222222222222222222222222222222222222222222222222wvu111111111-~~-####::::::#####-1111111111111111111111111111111111111111
22222222222222222222222222222222222222222222222trqp111111111-~~1####:OPQR:#####-1111111111111111111111111111111111111111
2222222222222222222222222222222222222222222222trqps111111111-~~1####:STUV:#####-11111111111111111111111111111111111111
cccccccccccccccccccccccccccccccccccccccccccccccqps1111111111-~~1####:WXYZ:#####-111111111111111111111111111111111111
bbbbbbbbbbbbbbbbbbbbbbbbbbbbbbbbbbbbbbbbbbbbbbbps1111,111111-~~-####:!"£$:#####-1111111111111111111111111111111111
aaaaaaaaaaaaaaaaaaaaaaaaaaaaaaaaaaaaaaaaaaaaaaas111111111111-~~-####:%^&*:#####-111111111111111111111111111111111111111
)1111111111111~~11111111111111111111111111111111111111111111-~~-####::::::#####-11111111111111111111111111111111
)1111111111111~~11111111111111111111111111111111111111111111-~~-######@@#######-111111111111111111111111111111111
)1118811111111~~111111111111111111111111111111111111111111111~~-######@@#######-111111111111111111111111111111111
)11111111:1111~~1111111111111111111@@111111111111111111111111~~-######@@#######-1111111111111111111111111111111111
)1111111111111~~11111111111118111111111111111111111111111111-~~-######@@#######-3111111111111111111111111111111111111111
)1111111111111~~11111111111111111111111111111111111111111111-~~-######@@#######-1111111111111111111111111111111111111111
((((((((((((((((((((((((((((((((((((((((((((((((((((((((((((((((((((((((((((((((1111111111111111111111111111111111111111
1111111111111111111111111111111111(((((111111111111111111111111111111111111111111111111111111111111111111111111111111111
111111111111111111111111111111111111111111111111111111111111111111111111111111111111111111111111111111111111111111111111
111111111111111111111111111111111111111111111111111111111111111111111111111111111111111111111111111111111111111111111111
111111111111111111111111111111111111111111111111111111111111111111111111111111111111111111111111111111111111111111111111
111111111111111111111111111111111111111111111111111111111111111111111111111111111111111111111111111111111111111111111111
111111111111111111111111111111111111111111111111111111111111111111111111111111111111111111111111111111111111111111111111
111111111111111111111111111111111111111111111111111111111111111111111111111111111111111111111111111111111111111111111111
111111111111111111111111111111111111111111111111111111111111111111111111111111111111111111111111111111111111111111111111
111111111111111111111111111111111111111111111111111111111111111111111111111111111111111111111111111111111111111111111111
111111111111111111111111111111111111111111111111111111111111111111111111111111111111111111111111111111111111111111111111
111111111111111111111111111111111111111111111111111111111111111111111111111111111111111111111111111111111111111111111111
111111111111111111111111111111111111111111111111111111111111111111111111111111111111111111111111111111111111111111111111
111111111111111111111111111111111111111111111111111111111111111111111111111111111111111111111111111111111111111111111111
111111111111111111111111111111111111111111111111111111111111111111111111111111111111111111111111111111111111111111111111
111111111111111111111111111111111111111111111111111111111111111111111111111111111111111111111111111111111111111111111111
111111111111111111111111111111111111111111111111111111111111111111111111111111111111111111111111111111111111111111111111
111111111111111111111111111111111111111111111111111111111111111111111111111111111111111111111111111111111111111111111111
111111111111111111111111111111111111111111111111111111111111111111111111111111111111111111111111111111111111111111111111
111111111111111111111111111111111111111111111111111111111111111111111111111111111111111111111111111111111111111111111111
111111111111111111111111111111111111111111111111111111111111111111111111111111111111111111111111111111111111111111111111
111111111111111111111111111111111111111111111111111111111111111111111111111111111111111111111111111111111111111111111111
111111111111111111111111111111111111111111111111111111111111111111111111111111111111111111111111111111111111111111111111
111111111111111111111111111111111111111111111111111111111111111111111111111111111111111111111111111111111111111111111111
111111111111111111111111111111111111111111111111111111111111111111111111111111111111111111111111111111111111111111111111
111111111111111111111111111111111111111111111111111111111111111111111111111111111111111111111111111111111111111111111111
