((((((((((((((((((((((((((((((((((((((((((((((((((((((((((((((((((((((((((((((((1111111111111111111111111111111111111111
)1111111111111~~111111111111111111111111111111111111111111111~~1111111111111111-3111111111111111111111111111111111111111
)1111111111111~~1111111111111111##111111111111111111111111111~~111>11>11>11>111-3111111111111111111111111111111111111111
)1111111111111~~111111111111111111111111111#11111111111111111~~1111111111111111--111111111111111111111111111111111111111
)1111111111111~~111111111111111111111111111111111111111111111~~1111111111111111--111111111111111111111111111111111111111
)1111111111111~~1111@@@@@@@@@@1111111111111111111111111111111~~1111111111111111--111111111111111111111111111111111111111
)1111111111111~~1111###::::###1111111111111111111111111111111~~111/11/11/11/111--111111111111111111111111111111111111111
)1111111111111~~1111###::::###111111111111111111##11111111111~~1111111111111111--111111111111111111111111111111111111111
)1111111111111~~1111@@@@@@@@@@1111111111111111111111111111111~~1111111111111111-1111111111111111111111111111111111111111
)1111111111111~~1111111111111111111IDDDDDDDDDDDDDDDDDDDDDDDDD[{DDDDDDDDDDDDDDDDD1111111111111111111111111111111111111111
)1111111111111~~111111111111111111IJEEEEEEEEEEEEEEEEEEEEEEEEE[{EEEEEEEEEEEEEEEEEE111111111111111111111111111111111111111
)1111111111111~~11111111111111111IJK_________________________[{_________________1111111111111111111111111111111111111111
)1111111111111~~1111111111111111IJK+1111111111111111111111111~~1111111111111111-1111111111111111111111111111111111111111
DDDDDDDDDDDDDD[{DDDDDDDDDDDDDDDDJK+1:#:1111111111111111111111~~1111111111111111-1111111111111111111111111111111111111111
EEEEEEEEEEEEEE[{EEEEEEEEEEEEEEEEK+111111111111111111111111111~~1111111111111111-1111111111111111111111111111111111111111
______________[{________________+((((((((((((((((111111111111~~1111111111111111-1111111111111111111111111111111111111111
)111111111111-~~)11111111111111111111111111111111111111111111~~1111111111111111-1111111111111111111111111111111111111111
)811111111111-~~)1>11/111111111111111111111111111111111111111~~1111111111111111-1111111111111111111111111111111111111111
)11OPQR1,1111-~~)11111111111111111111111111111111111111111111~~1111111111111111-1111111111111111111111111111111111111111
)11STUV1,1111-~~((((((111111111111111111111111111111111111111~~1111111111111111-3111111111111111111111111111111111111111
)11WXYZ111111-.................................................1111111111111111-3111111111111111111111111111111111111111
)11!"£$111111-<<<<<<<<<<<<<<<<<<<<<<<<<<<<<<<<<<<<<<<<<<<<<<<<<1111111111111111-1111111111111111111111111111111111111111
)11%^&*111111-~~((((((111111111111111111111111111111111111111~~1111111111111111-1111111111111111111111111111111111111111
)111111111111-~~)11111111111111111111111111111111111111111111~~1111111111111111-1111111111111111111111111111111111111111
)OPQR11111111-~~)11111111111111111111111111111111111111111111~~1111111111111111-1111111111111111111111111111111111111111
)STUV11111111-~~)11111111111111111111111111111111111111111111~~1111111111111111-1111111111111111111111111111111111111111
)WXYZ11111111-~~)11111111111111111111111111111111111111111111~~1111111111111111-1111111111111111111111111111111111111111
)!"£$111111111~~111111111111111111111IDDDDDDDz11111111,111111~~1111111111111111-1111111111111111111111111111111111111111
)%^&*111111111~~1111111111,111111111IJEEEEEEExz11111111111111~~1111111111111111-3111111111111111111111111111111111111111
)1111111111111~~1111111111111111111IJKFFFFFFFyxz1111111111111~~1111111111111111-3111111111111111111111111111111111111111
)1111811111111~~111111111111111111IJKLGGGGGGGAyxz111111111111~~1111111111111111-3111111111111111111111111111111111111111
)1111111111111~~11111111111111111IJKLMHHHHHHHBAyxz11111111111~~1111111111111111-3111111111111111111111111111111111111111
DDDDDDDDDDDDDDDDDDDDDDDDDDDDDDDDDJKLMN2222222CBAyxz1111111111~~1111111111111111-1111111111111111111111111111111111111111
EEEEEEEEEEEEEEEEEEEEEEEEEEEEEEEEEKLMN222222222CBAyx1111111111~~1111111111111111-3111111111111111111111111111111111111111
FFFFFFFFFFFFFFFFFFFFFFFFFFFFFFFFFLMN22222222222CBAu1111111111~~1111111111111111-1111111111111111111111111111111111111111
GGGGGGGGGGGGGGGGGGGGGGGGGGGGGGGGGMN2222222222222wvu1111111111~~1111111111111111-1111111111111111111111111111111111111111
HHHHHHHHHHHHHHHHHHHHHHHHHHHHHHHHHN22222222222222wvu1111111111~~1111111111111111-1111111111111111111111111111111111111111
222222222222222222222222222222222222222222222222wvu1111111111~~111111111,111111-1111111111111111111111111111111111111111
22222222222222222222222222222222222222222222222trqp1111111111~~1111111111111111-1111111111111111111111111111111111111111
2222222222222222222222222222222222222222222222trqps1111111111~~1111111111111111-1111111111111111111111111111111111111111
cccccccccccccccccccccccccccccccccccccccccccccccqps11111111111~~1111111111111111-1111111111111111111111111111111111111111
bbbbbbbbbbbbbbbbbbbbbbbbbbbbbbbbbbbbbbbbbbbbbbbps1111,1111111~~1111111111111111-1111111111111111111111111111111111111111
aaaaaaaaaaaaaaaaaaaaaaaaaaaaaaaaaaaaaaaaaaaaaaas1111111111111~~1111111111111111-1111111111111111111111111111111111111111
)1111111111111~~111111111111111111111111111111111111111111111~~1111111111,11111-1111111111111111111111111111111111111111
)1111111111111~~111111111111111111111111111111111111111111111~~1111111111111111-1111111111111111111111111111111111111111
)1118811111111~~111111111111111111111111111111111111111111111~~1111111111111111-3111111111111111111111111111111111111111
)11111111:1111~~1111111111111111111@@111111111111111111111111~~1111111111111111-3111111111111111111111111111111111111111
)1111111111111~~111111111111181111111111111111111111111111111~~1111111111111111-3111111111111111111111111111111111111111
)1111111111111~~111111111111111111111111111111111111111111111~~1111111111111111-1111111111111111111111111111111111111111
((((((((((((((((((((((((((((((((((((((((((((((((((((((((((((((((((((((((((((((((1111111111111111111111111111111111111111
1111111111111111111111111111111111(((((111111111111111111111111111111111111111111111111111111111111111111111111111111111
111111111111111111111111111111111111111111111111111111111111111111111111111111111111111111111111111111111111111111111111
111111111111111111111111111111111111111111111111111111111111111111111111111111111111111111111111111111111111111111111111
111111111111111111111111111111111111111111111111111111111111111111111111111111111111111111111111111111111111111111111111
111111111111111111111111111111111111111111111111111111111111111111111111111111111111111111111111111111111111111111111111
111111111111111111111111111111111111111111111111111111111111111111111111111111111111111111111111111111111111111111111111
111111111111111111111111111111111111111111111111111111111111111111111111111111111111111111111111111111111111111111111111
111111111111111111111111111111111111111111111111111111111111111111111111111111111111111111111111111111111111111111111111
111111111111111111111111111111111111111111111111111111111111111111111111111111111111111111111111111111111111111111111111
111111111111111111111111111111111111111111111111111111111111111111111111111111111111111111111111111111111111111111111111
111111111111111111111111111111111111111111111111111111111111111111111111111111111111111111111111111111111111111111111111
111111111111111111111111111111111111111111111111111111111111111111111111111111111111111111111111111111111111111111111111
111111111111111111111111111111111111111111111111111111111111111111111111111111111111111111111111111111111111111111111111
111111111111111111111111111111111111111111111111111111111111111111111111111111111111111111111111111111111111111111111111
111111111111111111111111111111111111111111111111111111111111111111111111111111111111111111111111111111111111111111111111
111111111111111111111111111111111111111111111111111111111111111111111111111111111111111111111111111111111111111111111111
111111111111111111111111111111111111111111111111111111111111111111111111111111111111111111111111111111111111111111111111
111111111111111111111111111111111111111111111111111111111111111111111111111111111111111111111111111111111111111111111111
111111111111111111111111111111111111111111111111111111111111111111111111111111111111111111111111111111111111111111111111
111111111111111111111111111111111111111111111111111111111111111111111111111111111111111111111111111111111111111111111111
111111111111111111111111111111111111111111111111111111111111111111111111111111111111111111111111111111111111111111111111
111111111111111111111111111111111111111111111111111111111111111111111111111111111111111111111111111111111111111111111111
111111111111111111111111111111111111111111111111111111111111111111111111111111111111111111111111111111111111111111111111
111111111111111111111111111111111111111111111111111111111111111111111111111111111111111111111111111111111111111111111111
111111111111111111111111111111111111111111111111111111111111111111111111111111111111111111111111111111111111111111111111
