11111111111111111111111111111111111111111111111111
10000000000000000000033222223300000000000000000031
10000000000000000000033222223300000000000000000031
10000000000000000000033222223300000000000000000031
10000000000000000000033222223300000000000000000031
10000000000000000000033222223300000000000000000031
10000000000000000000033222223300000000000000000031
10000000000000000000033222223300000000000000000031
10000000000000000000033222223300000000000000000031
10000000000000000000033222223300000000000000000031
10000000000000000000033222223300000000000000000031
10000000000000000000033222223300000000000000000031
10000000000000000000033222223300000000000000000031
10000000000000000000033222223300000000000000000031
10000000000000000000033222223300000000000000000031
10000000000000000000033222223300000000000000000031
10000000000000000000033222223300000000000000000031
10000000000000000000000000000000000000000000000031
10000000000000000000000000000000000000000000000031
10000000000000000000000000000000000000000000000031
10000000000000000000033222223300000000000000000031
10000000000000000000033222223300000000000000000031
10000000000000000000033222223300000000000000000031
10000000000000000000033222223300000000000000000031
10000000000000000000033222223300000000000000000031
10000000000000000000033222223300000000000000000031
10000000000000000000033222223300000000000000000031
10000000000000000000033222223300000000000000000031
10000000000000000000033222223300000000000000000031
10000000000000000000033222223300000000000000000031
10000000000000000000033222223300000000000000000031
10000000000000000000033222223300000000000000000031
10000000000000000000033222223300000000000000000031
10000000000000000000033222223300000000000000000031
10000000000000000000033222223300000000000000000031
10000000000000000000033222223300000000000000000031
10000000000000000000033222223300000000000000000031
10000000000000000000033222223300000000000000000031
13333333333333333333333222223333333333333333333331
11111111111111111111111111111111111111111111111111