111111111111111111111111111111
111111222221333333314444444111
111111111111111111111111111111
115555555166666661777777711111
111111111111111111111111111111
111111111111111111111111111111
111111111111111111111111111111
111111111111111111111111111111
111111111111113311111111111111
111111111111133111311111111111
111111111111131111311111111111
111111111111331111311111111111
111111111111311333311111111111
111111111111313313311111111111
111111111111333113311111111111
111111111111331133311111111111
111111111111331331311111111111
111111111111333313311111111111
111111111111333113111111111111
111111111111333331111111111111
111111111111111111111111111111
111111111111111111111111111111
111111111111111111111111111111
111111111111111111111111111111
111111111111111111111111111111
111111111111111111111111111111
111111111111111111111111111111
111111111111111111111111111111
111111111111111111111111111111
111111111111111111111111111111
