33333333333333333333333333333333mvo22222
31111111111111111111111111111111mvo22222
31111111111111111111111111111111mvo22222
31111111111111111111111111111111mvo22222
3111111111111111111)111111111111mvo22222
3311111OPQR11111111)111111111111mvo22222
3811111STUV11111111)111111111111fghk2222
3881111WXYZ11114511)111111111111efghk222
3888111!"£$11116711)1111111111111efghk22
3888811%^&*11111111)11111111111111efghk2
3888881111118888888)111111111111111efghd
3888888111888888888)1111111111111111efgc
3(((((()11((((((((()11111111111111111efb
3111111)11)11111111)111111111111111111ea
3111111)11)11)(((1()11111111111111111111
3111111)11)1)11111IDDDDDD[{DDDz111111111
3111111)11))11111IJEEEEEE[{EEExz11111111
3111111)11)11111IJKFFFFFF[{FFFyxz1111111
311111111111111IJKL______[{___Ayxz111111
31111111111111IJKL+11111111111=Ayxz11111
DDD[{DDDDDDDDDJKL+1111111111111=Ayxz1111
EEE[{EEEEEEEEEKL+111111111111111=Ayxz111
FFF[{FFFFFFFFFL+11111111111111111=Ayx111
___[{_________+1111111111111111111=Au111
11111111111111111111111111111111111=u111
