111111111111111111111111111111111111111111111111111111111111
111222222222222222113333333333333311444444444444441111111111
111222222222222222113333333333333311444444444444441111111111
111222222222222222113333333333333311444444444444441111111111
111222222222222222113333333333333311444444444444441111111111
111222222222222222113333333333333311444444444444441111111111
111222222222222222113333333333333311444444444444441111111111
111222222222222222113333333333333311444444444444441111111111
111222222222222222113333333333333311444444444444441111111111
111222222222222222113333333333333311444444444444441111111111
111222222222222222113333333333333311444444444444441111111111
111222222222222222113333333333333311444444444444441111111111
111111111111111111111111111111111111111111111111111111111111
111555555555555555116666666666666611777777777777771111111111
111555555555555555116666666666666611777777777777771111111111
111555555555555555116666666666666611777777777777771111111111
111555555555555555116666666666666611777777777777771111111111
111555555555555555116666666666666611777777777777771111111111
111555555555555555116666666666666611777777777777771111111111
111555555555555555116666666666666611777777777777771111111111
111555555555555555116666666666666611777777777777771111111111
111555555555555555116666666666666611777777777777771111111111
111555555555555555116666666666666611777777777777771111111111
111111111111111111111111111111111111111111111111111111111111
111111111111111111111111111111111111111111111111111111111111
111111111111111111111111111111111111111111111111111111111111
111111111111111111111111111111111111111111111111111111111111
111111111111111111111111111111111111111111111111111111111111
111111111111111111111111111111111111111111111111111111111111
111111111111111111111111111111111111111111111111111111111111
111111111111111111111111111111111111111111111111111111111111
111111111111111111111111111111111111111111111111111111111111
111111111111111111111111111111111111111111111111111111111111
111111111111111111111111111111111111111111111111111111111111
111111111111111111111111111111111111111111111111111111111111
111111111111111111111111111111111111111111111111111111111111
111111111111111111111111111111111111111111111111111111111111
111111111111111111111111111111111111111111111111111111111111
111111111111111111111111111111111111111111111111111111111111
111111111111111111111111111111111111111111111111111111111111
