33333333333333333333333333333333mvo22222222222222wvu33333333333333333333333333333333333333333333333333333333333333333333
31111111111111111111111111111111mvo22222222222222wvu11111111111111111111111111111111111111111111111111111111111111111113
31111111111111111111111111111111mvo22222222222222wvu11111111111111811111111111111111111111111111111111111111111111111113
31111111111181111111111111111111mvo22222222222222wvu11111111111111888888111111111111111111111111111111111111111111111113
31111111111181111111111111111111mvo22222222222222wvu11111111111111111111111111111111111111111111111111111111111111111113
31111111111111111111111111181111mvo2222222222222trqp11111111111111888888111111111111111111111111111111111111111111111113
31111111111111111111111111111111fghk22222222222trqps11111111111111811111111111111111111111111111111111111111111111111113
31111111111111111111111111111111efghk222222222trqps111111111111111111111111111111111111111111111111111111111111111111113
311111111111111111111111111111111efghk2222222trqps1111111111111111111111111111111111111111111111111111111111111111111113
3111111111111111111111111111111111efghk22222trqps11111111111111111111111111111111111111111111111111111111111111111111113
31111111111111111118111111111111111efghdddddrqps111111111111111111111111111111111111111111111111111111111111111111111113
311111111111111111111111111111111111efgcccccqps1111111111111111111111111111111111111111111111111111111111111111111111113
3111111111111111111111111111111111111efbbbbbps11111111111111111111111111111111111111111111111111111111111111111111111113
31111111111111111111111111111111111111eaaaaas111111111111111111111111111111111111111111111111111111111111111111111111113
311888111111111111111111111111111111111111111111111111111111111111111111111111111111111111111111111111111111111111111113
311838111111111111IDDDDDDDDDDDz111111111111111111111IDDDDDDDDDDDDDDDDz11111111111111111111111111111111111111111111111113
31188811111111111IJEEEEEEEEEEExz1111111111111111111IJEEEEEEEEEEEEEEEExz1111111111111111111111111111111111111111111111113
3111111111111111IJKFFFFFFFFFFFyxz11111111111111111IJKFFFFFFFFFFFFFFFFyxz111111111111111111111111111111111111111111111113
311111111111111IJKLGGGGGGGGGGGAyxz111111111111111IJKLGGGGGGGGGGGGGGGGAyxz11111111111111111111111111111111111111111111113
31111111111111IJKLMHHHHHHHHHHHBAyxz1111111111111IJKLMHHHHHHHHHHHHHHHHBAyxz1111111111111111111111111111111111111111111113
DDDDDDDDDDDDDDJKLMN22222222222CBAyxz11111111111IJKLMN2222222222222222CBAyxz111111111111111111111111111111111111111111113
EEEEEEEEEEEEEEKLMN2222222222222CBAyxz111111111IJKLMN222222222222222222CBAyxz11111111111111111111111111111111111111111113
FFFFFFFFFFFFFFLMN222222222222222CBAyx111111111JKLMN22222222222222222222CBAyx11111111111111111111111111111111111111111113
GGGGGGGGGGGGGGMN22222222222222222CBAu111111111mLMN2222222222222222222222CBAu11111111111111111111111111111111111111111113
HHHHHHHHHHHHHHN2222222222222222222wvu111111111mvo222222222222222222222222wvu11111111111111111111111111111111111111111113
2222222222222222222222222222222222wvu111111111mvo222222222222222222222222wvu11111111111111111111111111111111111111111113
2222222222222222222222222222222222wvu111111111mvo222222222222222222222222wvu11111111111111111111111111111111111111111113
2222222222222222222222222222222222wvu111111111mvo222222222222222222222222wvu11111111111111111111111111111111111111111113
2222222222222222222222222222222222wvu111111111mvo222222222222222222222222wvu11111111111111111111111111111111111111111113
222222222222222222222222222222222trqp111111111fghk2222222222222222222222trqp11111111111111111111111111111111111111111113
22222222222222222222222222222222trqps111111111efghk22222222222222222222trqps11111111111111111111111111111111111111111113
2222222222222222222222222222222trqps11111111111efghk222222222222222222trqps111111111111111111111111111111111111111111113
222222222222222222222222222222trqps1111111111111efghk2222222222222222trqps1111111111111111111111111111111111111111111113
ddddddddddddddddddddddddddddddrqps111111111111111efghk22222222222222trqps11111111111111111111111111111111111111111111113
ccccccccccccccccccccccccccccccqps11111111111111111efgccccccccccccccccqps111111111111111111111111111111111111111111111113
bbbbbbbbbbbbbbbbbbbbbbbbbbbbbbps1111111111111111111efbbbbbbbbbbbbbbbbps1111111111111111111111111111111111111111111111113
aaaaaaaaaaaaaaaaaaaaaaaaaaaaaas111111111111111111111eaaaaaaaaaaaaaaaas11111111111111111111111111111111111111111111111113
311111111111111111111111111111111111111111111111111111111111111111111111111111111111111111111111111111111111111111111113
311111111111111111111111111111111111111111111111111111111111111111111111111111111111111111111111111111111111111111111113
311111111111111111111111111111111111111111111111111111111111111111111111111111111111111111111111111111111111111111111113
311111111111111111111111111111111111111111111111111111111111111111111111111111111111111111111111111111111111111111111113
311111111111111111111111111111111111111111111111111111111111111111111111111111111111111111111111111111111111111111111113
311111111111111111111111111111111111111111111111111111111111111111111111111111111111111111111111111111111111111111111113
311111111111111111111111111111111111111111111111111111111111111111111111111111111111111111111111111111111111111111111113
311111111111111111111111111111111111111111111111111111111111111111111111111111111111111111111111111111111111111111111113
311111111111111111111111111111111111111111111111111111111111111111111111111111111111111111111111111111111111111111111113
311111111111111111111111111111111111111111111111111111111111111111111111111111111111111111111111111111111111111111111113
311111111111111111111111111111111111111111111111111111111111111111111111111111111111111111111111111111111111111111111113
311111111111111111111111111111111111111111111111111111111111111111111111111111111111111111111111111111111111111111111113
311111111111111111111111111111111111111111111111111111111111111111111111111111111111111111111111111111111111111111111113
311111111111111111111111111111111111111111111111111111111111111111111111111111111111111111111111111111111111111111111113
311111111111111111111111111111111111111111111111111111111111111111111111111111111111111111111111111111111111111111111113
311111111111111111111111111111111111111111111111111111111111111111111111111111111111111111111111111111111111111111111113
311111111111111111111111111111111111111111111111111111111111111111111111111111111111111111111111111111111111111111111113
311111111111111111111111111111111111111111111111111111111111111111111111111111111111111111111111111111111111111111111113
311111111111111111111111111111111111111111111111111111111111111111111111111111111111111111111111111111111111111111111113
311111111111111111111111111111111111111111111111111111111111111111111111111111111111111111111111111111111111111111111113
311111111111111111111111111111111111111111111111111111111111111111111111111111111111111111111111111111111111111111111113
311111111111111111111111111111111111111111111111111111111111111111111111111111111111111111111111111111111111111111111113
311111111111111111111111111111111111111111111111111111111111111111111111111111111111111111111111111111111111111111111113
311111111111111111111111111111111111111111111111111111111111111111111111111111111111111111111111111111111111111111111113
311111111111111111111111111111111111111111111111111111111111111111111111111111111111111111111111111111111111111111111113
311111111111111111111111111111111111111111111111111111111111111111111111111111111111111111111111111111111111111111111113
311111111111111111111111111111111111111111111111111111111111111111111111111111111111111111111111111111111111111111111113
311111111111111111111111111111111111111111111111111111111111111111111111111111111111111111111111111111111111111111111113
311111111111111111111111111111111111111111111111111111111111111111111111111111111111111111111111111111111111111111111113
311111111111111111111111111111111111111111111111111111111111111111111111111111111111111111111111111111111111111111111113
311111111111111111111111111111111111111111111111111111111111111111111111111111111111111111111111111111111111111111111113
311111111111111111111111111111111111111111111111111111111111111111111111111111111111111111111111111111111111111111111113
311111111111111111111111111111111111111111111111111111111111111111111111111111111111111111111111111111111111111111111133
311111111111111111111111111111111111111111111111111111111111111111111111111111111111111111111111111111111111111111111113
311111111111111111111111111111111111111111111111111111111111111111111111111111111111111111111111111111111111111111111113
311111111111111111111111111111111111111111111111111111111111111111111111111111111111111111111111111111111111111111111113
311111111111111111111111111111111111111111111111111111111111111111111111111111111111111111111111111111111111111111111113
333333333333333333333333333333333333333333333333333333333333333333333333333333333333333333333333333333333333333333333333