44444444444444444444444444444444444444444444444444444444444
44441111111111111111111111111111111111111111111111111111114
44411111111111111111111111111111111111111111111111111111114
44111111111111111111111111111111111111111111111111111111114
41111111111111111111111111111111111111111111111111111111114
41111111111111111111111111111111111111111111111111111111114
41111111111111111111111111111111111111111111111111111111114
41111111111111111111111111111111111111111111111111111111114
41111111111111111111111111111111111111111111111111111111114
41111111111111111111111111111111111111111111111111111111114
41111111111111111111111111111111111111111111111111111111114
41111111111111111111111111111111111111111111111111111111114
41111111111111111111111111111111111111111111111111111111114
41111111111111111111111111111111111111111111111111111111114
41111111111111111111111111111111111111111111111111111111114
41111111111111111111111111111111111111111111111111111111114
41111111111111111111111111111111111111111111111111111111114
41111111111111111111111111111111111111111111111111111111114
41111111111111111111111111111111111111111111111111111111114
41111111111111111111111111111111111111111111111111111111114
41111111111111111111111111111111111111111111111111111111114
41111111111111111111111111111111111111111111111111111111114
41111111111111111111111111111111111111111111111111111111114
41111111111111111111111111111111111111111111111111111111114
41111111111111111111111111111111111111111111111111111111114
41111111111111111111111111111111111111111111111111111111114
41111111111111111111111111111111111111111111111111111111114
41111111111111111111111111111111111111111111111111111111114
41111111111111111111111111111111111111111111111111111111114
41111111111111111111111111111111111111111111111111111111114
41111111111111111111111111111111111111111111111111111111114
41111111111111111111111111111111111111111111111111111111114
41111111111111111111111111111111111111111111111111111111114
41111111111111111111111111111111111111111111111111111111114
41111111111111111111111111111111111111111111111111111111114
41111111111111111111111111111111111111111111111111111111114
41111111111111111111111111111111111111111111111111111111114
41111111111111111111111111111111111111111111111111111111114
41111111111111111111111111111111111111111111111111111111114
41111111111111111111111111111111111111111111111111111111114
41111111111111111111111111111111111111111111111111111111114
41111111111111111111111111111111111111111111111111111111114
41111111111111111111111111111111111111111111111111111111114
41111111111111111111111111111111111111111111111111111111114
41111111111111111111111111111111111111111111111111111111114
41111111111111111111111111111111111111111111111111111111114
41111111111111111111111111111111111111111111111111111111114
41111111111111111111111111111111111111111111111111111111114
41111111111111111111111111111111111111111111111111111111114
44444444444444444444444444444444444444444444444444444444444
