1111111111111111111111111111111111111111
1111111111111111111111111111111111111111
1111111111111111111111111111111111111111
1111111111111111111111111111111111111111
1111111111111111111111111111311111111111
1111311111111111111111111111111111111111
1111311111111111111111111111111111111111
1111111111111111111111111111111111111111
1111111111111111111111111111111113331111
1111111111111111111111111111111113631111
1111111113111111111111111111111113331111
111111111111111111IDDDDDDDDz111111111111
11111111111111111IJEEEEEEEExz11111111111
1111111111111111IJKGGGGGGGAyxz1111111111
111111111111111IJKMHHHHHHHBAyxz111111111
11111111111111IJKMN2222222CBAyxz11111111
DDDDDDDDDDDDDDJKMN222222222CBAyxz1111111
EEEEEEEEEEEEEEKMN22222222222CBAyxz111111
GGGGGGGGGGGGGGMN2222222222222CBAyxDDDDDD
HHHHHHHHHHHHHHN222222222222222CBAyEEEEEE
22222222222222222222222222222222BAFFFFFF
22222222222222222222222222222222CBGGGGGG
222222222222222222222222222222222CHHHHHH
2222222222222222222222222222222222222222
2222222222222222222222222222222222222222
