11111111111111111111111111111111111111111111111111
13333333333333333333333222223333333333333333333331
13000000000000000000033222223300000000000000000031
13000000000000000000033222223300000000000000000031
13000000000000000000033222223300000000000000000031
13000000000000000000033222223300000000000000000031
13000000000000000000033222223300000000000000000031
13000000000000000000033222223300000000000000000031
13000000000000000000033222223300000000000000000031
13000000000000000000033222223300000000000000000031
13000000000000000000033222223300000000000000000031
13000000000000000000033222223300000000000000000031
13000000000000000000033222223300000000000000000031
13000000000000000000033222223300000000000000000031
13000000000000000000033222223300000000000000000031
13000000000000000000033222223300000000000000000031
13000000000000000000033333333300000000000000000031
13000000000000000000000003000000000000000000000031
13000000000000000000000000000000000000000000000031
13000000000000000000000003000000000000000000000031
13000000000000000000033333333300000000000000000031
13000000000000000000033222223300000000000000000031
13000000000000000000033222223300000000000000000031
13000000000000000000033222223300000000000000000031
13000000000000000000033222223300000000000000000031
13000000000000000000033222223300000000000000000031
13000000000000000000033222223300000000000000000031
13000000000000000000033222223300000000000000000031
13000000000000000000033222223300000000000000000031
13000000000000000000033222223300000000000000000031
13000000000000000000033222223300000000000000000031
13000000000000000000033222223300000000000000000031
13000000000000000000033222223300000000000000000031
13000000000000000000033222223300000000000000000031
13000000000000000000033222223300000000000000000031
13000000000000000000033222223300000000000000000031
13000000000000000000033222223300000000000000000031
13000000000000000000033222223300000000000000000031
13333333333333333333333222223333333333333333333331
11111111111111111111111111111111111111111111111111
